\n = \n
"A Very Long Phase" = "Очень долгий период"
"Adjusting to the Dark" = "Я привыкла к темноте"
"At the New House" = "В новом доме"
"Best-Laid Plans" = "Лучшие планы"
"Big Gold Star" = "Внутреннее cвечение"
"Daniel" = "Дэниэл"
"Dealing With Roots" = "Покраска волос"
"Dedication" = "Посвящение"
"Default Friends" = “Друзья по-умолчанию”
"First Day of School" = "Первый день в школе”
"Getting Lonnie" = "Понять Лонни"
"Hanging Out With Girls" = "Тусоваться с девчонками"
"I Can Sing" = "Я могу спеть"
"I Said Yes" = "Я сказала, да"
"In The Attic" = "На чердаке"
"It's Different Now" = "Теперь все иначе"
"Just Gone" = "Она просто исчезнет"
"Lie-to-Mom-and-Dad Situation" = “Ситуация соври-маме-и-папе”
"Life Moves On" = "Жизнь продолжается"
"Meow meow, meow" = "Мяу мяу, мяу"
"Ship Date" = "Дата отправления"
"Stick With The Group" = "Держись с группой"
"The Nunnery" = "Женский монастырь"
"There Was Nothing Wrong" = “В этом не было ничего плохого”
"Where I Need To Be" = "Я там, где должна быть"
(Custom) = (Пользовательские)
? = ?
\nHey Sam,\n\nI'm writing to you from Multnomah Falls! I'm here on a stupid class trip which is stupid because it's March and I don't know if anyone running this school has been to Oregon but it's cold and rainy as shit in March!\n\nWish you were here! OH WAIT YOU ARE HERE because I'm writing this to you in the gift shop oh shit here you come\n\n-L = \nПривет Сэм,\n\nпишу тебе с водопада Мултнома! Я тут с дурацкой школьной экскурсией, которая дурацкая, потому что сейчас уже март. Уж не знаю, бывал ли кто-то из руководства школы в Орегоне, но в марте тут холод собачий, и льет как из ведра! Жаль, что тебя здесь нет! ПОДОЖДИ-КА, ЭТО ЖЕ ТЫ, а я тут пишу тебе открытку в сувенирной лавке. Боже мой, вон ты идешь\n\n-Л
101.9 KINK FM Presents\n\nEarth, Wind & Fire\n\nKeller Auditorium\n\nThu Feb 23, 1995 8:00 PM = 101.9 KINK FM Представляет\n\n"Earth, Wind & Fire"\n\nАудитория Келлера\n\nЧт 23 февраля, 1995 20:00
1024x768 = 1024x768
1280x720 = 1280x720
1600x1200 = 1600x1200
1600x900 = 1600x900
1920x1080 = 1920x1080
60 = 60
65 = 65
70 = 70
75 = 75
80 = 80
85 = 85
90 = 90
A hand-drawn little map that looks like it leads to somewhere in the house... = Небольшая нарисованная карта, похоже она приведет к чему-то в доме...
A letter from Granddad = Письмо от дедушки
A spare key that was hidden under ol' Christmas Duck. = Запасной ключ, был спрятан под старой Рождественской Уткой.
A Stranger Under My Roof\nUnderstanding Teens = "Незнакомец под моей крышей"\nВосприятие подростков
Accept = Принять
Active Modifiers:\n = Активные модификации:\n
added to backpack = я положила в рюкзак
Adjust Brightness = Настройка яркости
Adjust Field of View = Настроить угол обзора
-Advanced Options- = - ДОПОЛНИТЕЛЬНЫЕ НАСТРОЙКИ -
Adventurous the Cat Returns = "Adventurous the Cat Returns"
After the Honeymoon\n\nRediscovering Your Spouse: Personally, Spiritually, Sexually = "После медового месяца"\n\nВерните в ваши отношения: Доверие, Чувства, Сексуальность
All Doors Unlocked\n = Все двери открыты\n
ALL LIGHTS START ON - For those who\ndon't like the dark. = ВЕСЬ СВЕТ ВКЛЮЧЕН - Для тех, кто\nне любит темноту.
All Lights Start On\n = Все освещение включено\n
Ambient Occlusion = Затенение (AO)
Anisotropic Filtering = Анизотропная фильтрация
Another one of the postcards I sent! = Еще одна открытка, которую я отправляла
AntiAliasing = Сглаживание
Applying changes... = Применить изменения...
Apr. 10, 1995 = 10 апреля, 1995
Apr. 22, 1995 = 22 апреля, 1995
Apr. 5, 1995 = 5 апреля, 1995
Attic key = Ключ от чердака
Audio Diaries Disabled\n = Аудио дневники отключены\n
Aug. 20, 1994 = 20 августа, 1994
Aug. 30, 1994 = 30 августа, 1994
Awww, Mitten = Ах, Миттен
Back = Назад
Back to basics:\nSent back in time to Dallas 1963 again? = Вернуться к истокам:\nОтправленный назад в прошлое, в Даллас 1963 года. Опять?
Basement key = Ключ от подвала
Bloom = Свечение
Boarding pass = Посадочный талон
Bratmobile = Bratmobile
Bratmobile\n\nCool Schmool = Bratmobile\n\nCool Schmool
Bratmobile\n\nPottymouth = Bratmobile\n\nPottymouth
Bratmobile\n\nSome Special = Bratmobile\n\nSome Special
Bratmobile\n\nThe Revue 3/26 = Bratmobile\n\nThe Revue 3/26
CALL DANIEL BACK!! = ПЕРЕЗВОНИ ДЭНИЭЛУ!
Cancel = Отмена
Captain A.\n\nRev-L-Ution Grrrl = Капитан А.\n\nРево-Л-юшн Герррл
Captain Allegra\nand\nthe First Mate\n\n\n\n\nYour Costume\n\nMy Costume\n-L = Капитан Аллегра\nи\nПервый помощник\n\n\n\n\nТвой костюм\n\nМой костюм\n-Л
CAUTION\nRADIATION AREA\nKEEP OUT = ВНИМАНИЕ!\nРАДИОАКТИВНАЯ ЗОНА\nНЕ ВХОДИТЬ
Chinese?\nJapanese\nLebanese? = Китайцы?\nЯпонцы\nЛиванцы?
Close armoire = Закрыть шкаф
Close cabinet = Закрыть шкафчик
Close cover = Закрыть крышку
Close dishwasher = Закрыть посудомоечную машину
Close dishwasher rack = Задвинуть корзину для посуды
Close door = Закрыть дверь
Close drawer = Закрыть ящик
Close dryer = Закрыть сушилку
Close folder = Закрыть папку
Close fridge = Закрыть холодильник
Close hamper = Закрыть корзину
Close lid = Закрыть крышку
Close locker = Закрыть шкафчик
Close microwave = Закрыть микроволновку
Close panel = Закрыть панель
Close pizza box = Закрыть коробку из-под пиццы
Close safe = Закрыть сейф
Close sliding door = Закрыть дверцу
Close trunk = Закрыть сундук
Close washer = Закрыть стиральную машину
Completed combination to Sam's locker = Полная комбинация от шкафчика Сэм
Configure Controls = Настройка управления
Control = Действия
Controls = Управлениe
Crouch = Присесть
Crouch Style: = Режим присед.:
Crown Burger: Sam = Crown Burger: Сэм
Current Language: = Текущий язык:
Dad's\nOffice = Кабинет\nпапы
DANGER\n\nWear goggles and rubber gloves when handling anything in this room = ВНИМАНИЕ! ОПАСНОСТЬ!!\n\nНадевайте защитные очки и резиновые перчатки при работах в этой комнате
Daniel Called = Звонил Дэниэл
Daniel called again. He wants his Ninetendo game back. = Дэниэл снова звонил. Он хочет забрать свою Nintendo.
Daniel says he's coming over to get his game back = Дэниэл сказал, что он зайдет, чтобы забрать свою приставку
Darkroom = Фотолаборатория
Dear Mom, Dad, and Sam,\n\nI am in the CHUNNEL! This is my second passage through the CHUNNEL! I'm on my way back from London, this time going to Brussels, Belgium. Sorry I didn't write you on the way to London but I was too excited about the CHUNNEL!!\n\nLondon was great. Dad, I know you've always wanted to visit and I think you really should. You'd love it! If you all wanted to come back here as a family sometime I GUESS I could be convinced.\n\nLove you all!\n\nKatie = Дорогие мама, папа и Сэм,\n\nЯ в тоннеле под ЛА-МАНШЕМ! Это мой второй проезд через ТОННЕЛЬ! Я еду из Лондона, и в этот раз направляюсь в Брюссель, Бельгия. Сожалею, что не писала вам, когда первый раз ехала в Лондон, я была тогда слишком взволнована этим ТОННЕЛЕМ!\n\nЛондон великолепен. Папа, я знаю, что ты всегда хотел побывать в Лондоне, считаю, что тебе действительно стоит съездить. Тебе понравится! Если бы вы захотели приехать сюда всей семьей, я, ДУМАЮ, была бы не против.\n\nВсех целую!\n\nКэти
Dec. 8, 1994 = 8 декабря, 1994
Definitely not reading any more of that. = Я больше не буду читать это, хватит с меня.
Detect = АВТО
Dining\nRoom = Обеденная\nкомната
Disable Interaction Highlight = Отключить интерактивную подсветку
Disable Interaction Text = Отключить интерактивный текст
DISABLE MAP - There will be no in-game map\nto guide you. = ОТКЛЮЧИТЬ КАРТУ - В игре не будет карты\nдля ориентирования по дому.
DISABLE VOICE DIARIES - Checking this disables\nSam's voiceover. No ending prompt will appear.\nIt will be up to you when to stop playing. = ОТКЛЮЧИТЬ АУДИО ДНЕВНИК  - Сэм не будет читать\nзаписи дневника вслух. Аудиозапись можно \nбудет прервать в любой момент.
Display Subtitles = Показывать субтитры
Down a Floor = Этажем ниже
DUNK! = В ЯБЛОЧКО!
Early spaceflight: utopia\nAdvance techonlogy, end WWII early, time stream too different? = Ранние космические полеты: утопия\nПередовые технологии, раннее завершение Второй Мировой Войны, временные потоки слишком разные?
Eject tape = Извлечь кассету
En Espanol = En Espanol
Enable Headbob = Включить покачивание при ходьбе
Enter combination = Введите комбинацию
Escape from Ghost Mansion = Побег из особняка призраков
Examine book = Осмотреть книгу
Examine bookmark = Осмотреть закладку
Examine bottle = Осмотреть бутылку
Examine business card = Осмотреть визитку
Examine comic book = Осмотреть комикс
Examine composition book = Осмотреть тетрадь
Examine drawing = Осмотреть рисунок
Examine form = Осмотреть бланк
Examine magazine = Осмотреть журнал
Examine map = Осмотреть карту
Examine newspaper clipping = Осмотреть газетную вырезку
Examine note = Осмотреть записку
Examine page = Осмотреть страницу
Examine pamphlet = Осмотреть брошюру
Examine paper = Посмотреть лист бумаги
Examine paper scrap = Осмотреть клочок бумаги
Examine photo = Осмотреть фото
Examine scrap = Осмотреть обрывок бумаги
Examine show flyer = Осмотреть флаер на шоу
Examine slip = Посмотреть бланк
Examine stub = Осмотреть обрывок
Examine ticket = Осмотреть билет
Examine zine = Осмотреть журнал
Exit = Выход
Fastest = Минимум
Feb. 11, 1995 = 11 февраля, 1995
Flick bell = Щелкнуть колокольчик
Flip light switch = Переключить выключатель
Flush toilet = Смыть унитаз
FOR GOD SO LOVED THE WORLD\nHE GAVE HIS ONLY SON = ИБО ТАК ВОЗЛЮБИЛ БОГ МИР,\nЧТО ОТДАЛ СЫНА СВОЕГО ЕДИНОРОДНОГО
Foyer = Фойе
Frob Me Delicately = Frob Me Delicately
From the Desk of Richard Greenbriar Ph.D.\n\nDear Terrence,\nThank you for sending along a copy of your newly published book. An author's first published manuscript is a momentous occasion. I read it this afternoon. I certainly recognized my son in the subject matter. An author's work is the externalization of that which he holds dear (and that which he fears,) and in this respect I believe your work was successful. But the lens through which the personal shone was needlessly clouded by genre cliches and implausible dimestore science fictional dei ex machina. I congratulate you on the surviving the great ordeal that is publication, and rest assured that readers of your chosen genre will lap up copies hungrily. But I urge you to shed artifice.\n\nYou can do better.\n\nWith a father's love and encouragement,\nRichard Greenbriar Ph.D. = От имени доктора наук Ричарда Гринбрайара\n\nДорогой Терренс.\nБлагодарю за присланную копию твоей только что изданной книги. Дебютная публикация автора - это торжественный момент. Я прочитал копию этим днем. Безусловно, я узнал авторский стиль своего сына, ведь в книге проявляются важные для автора вещи и его страхи. В этом отношении, по моему мнению, работа удалась. Но призма, сквозь которую рассматривалась личность, была совершенно напрасно затуманена жанровыми клише и неправдоподобной дешевой нелогичной научно-фантастической развязкой. Я поздравляю тебя с тем, что ты преодолел это суровое испытание, которым явилась данная публикация, и смею заверить, что читатели выбранного тобой жанра буду жадно сметать копии с полок. Однако я настойчиво рекомендую тебе отбросить выдумки.\n\nТы способен на большее.\n\nС отцовской любовью и поддержкой,\nдоктор наук Ричард Гринбрайар.
Front Porch = Крыльцо
Full screen = На весь экран
Gameplay = Геймплей
Garage = Гараж
Girlscout\n\nSelf = Girlscout\n\nSelf
Girlscout\n\Role Model = Girlscout\n\nRole Model
Good ol' Christmas Duck. = Старая добрая Рождественская Утка.
Goodfellow High School = Старшая школа "Гудфеллоу"
Gosh, dad. = Боже, пап.
Gosh, Sam. = Боже, Сэм.
Got Your Number! = Есть твой номер!
Grab 3-ring binder = Взять папку
Grab apple = Взять яблоко
Grab bag = Взять пачку
Grab banana = Взять банан
Grab bell = Взять колокольчик
Grab boardgame = Взять настольную игру
Grab book = Взять книгу
Grab bottle = Взять бутылку
Grab bowl = Взять миску
Grab box = Взять коробку
Grab broom = Взять метлу
Grab brush = Взять кисть
Grab bunch of coupons = Взять пачку купонов
Grab button = Взять значок
Grab can = Взять банку
Grab candle = Взять свечу
Grab cartridge = Взять картридж
Grab cassette = Взять кассету
Grab chalk = Взять мелок
Grab cheese = Взять сыр
Grab chips = Взять чипсы
Grab Christmas Duck = Взять Рождественскую Утку
Grab cigarette pack = Взять пачку сигарет
Grab cleansing powder = Взять чистящий порошок
Grab coaster = Взять подставку
Grab collar = Взять ошейник
Grab comb = Взять расчестку
Grab cookie jar lid = Взять крышку от банки печенья
Grab couch pillow = Взять диванную подушку
Grab crucifix = Взять крест
Grab cup = Взять кружку
Grab cutting board = Взять разделочную доску
Grab Dad's second book = Взять вторую папину книгу
Grab detergent = Взять стиральный порошок
Grab die = Взять игральный кубик
Grab dustpan = Взять совок
Grab emery board = Взять пилочку для ногтей
Grab eraser = Взять ластик
Grab fork = Взять вилку
Grab glass = Взять стакан
Grab hairbrush = Взять расческу
Grab handsoap = Взять мыло для рук
Grab hat = Взять пилотку
Grab highlighter = Взять маркер
Grab ice cream = Взять мороженое
Grab jam = Взять варенье
Grab ketchup = Взять кетчуп
Grab knife = Взять нож
Grab label = Взять этикетку
Grab lid = Взять крышку
Grab lip balm = Взять бальзам для губ
Grab loose panel = Взять отпавшую панель
Grab manuscript = Взять рукопись
Grab marker = Взять фломастер
Grab matchbook = Взять спичечный коробок
Grab milk = Взять молоко
Grab mom's purse = Взять мамину сумочку
Grab mug = Взять кружку
Grab nail polish = Взять лак для ногтей
Grab nametag = Взять бейджик
Grab pack of cards = Взять колоду карт
Grab paint can = Взять банку с краской
Grab peanut butter = Взять арахисовое масло
Grab pen = Взять ручку
Grab pencil = Взять карандаш
Grab phone = Взять телефонную трубку
Grab photo = Взять фотографию
Grab photo paper = Взять фотобумагу
Grab pillow = Взять подушку
Grab plaque = Взять табличку
Grab plate = Взять тарелку
Grab poltergeist book = Взять книгу про полтергейстов
Grab postcard = Взять открытку
Grab pot = Взять кастрюлю
Grab relish = Взять приправу
Grab salad dressing = Взять заправку для салата
Grab scrap = Взять  кусочек бумаги
Grab shampoo = Взять шампунь
Grab shaving cream = Взять крем для бритья
Grab shot glass = Взять рюмку
Grab skull = Взять череп
Grab soda can = Взять банку газировки
Grab softener = Взять смягчитель
Grab spoon = Взять ложку
Grab syringe = Взять шприц
Grab tampon = Взять тампон
Grab textbook = Взять учебник
Grab throw pillow = Взять декоративную подушку
Grab tissue box = Взять салфетницу
Grab toilet paper = Взять туалетную бумагу
Grab toilet paper roll = Взять рулон туалетной бумаги
Grab toothbrush = Взять зубную щетку
Grab toothpaste = Взять зубную пасту
Grab toy = Взять игрушку
Grab uncrumpled manuscript = Взять разглаженную рукопись
Grab veggies = Взять овощи
Grab... Steggy? Stelly? = Взять... Стегги? Стелли?
Graphics = Графика
Graphics Quality: = КАЧЕСТВО\nГРАФИКИ
Grassy knoll steamrolled? = Снайпер с холма - навязанная теория?
Green\nHouse = Оранжерея
GRRRL JUSTICE NOW = GRRRL JUSTICE NOW
GRRRL JUSTICE NOW\n\nKicking Against the Patriarchy\n\nThe Great Goodfellow Riot of '95\n\nIssue #1!! = "GRRRL JUSTICE NOW"\n\nВыступая против патриархата\n\nВеликий бунт 95 года\n\nВыпуск #1!!
Guardian Angels Up Above\nBless This House With Lots of Love = Ангелы-хранители, пархая над землею,\nБлагословят сей дом божественной любовью
Guess this one's broken. = Думаю, она сломана.
Guest Room = Комната\nдля гостей
HAD ENOUGH?! = ДОСТАТОЧНО БЫЛО?!
Half of Sam's locker combo = Половина комбинации шкафчика Сэм
Hand-drawn map = Нарисованная карта
Hauntings & Poltergeists = Призраки и полтергейсты
Healthy Choices\n\nSkills for a Healthful Life = Правильный выбор\n\nПолезные навыки для здоровой жизни
HEARD ENOUGH? = НАСЛУШАЛАСЬ?
Heavens to Betsy = Heavens to Betsy
Heavens to Betsy\n\nBratmobile\n\nGirls to the Front! = Heavens to Betsy\n\nBratmobile\n\nДевчонки на фронт!
Heavens to Betsy\n\nCalculated = Heavens to Betsy\n\nCalculated
Heavens to Betsy\n\nNothing Can Stop Me = Heavens to Betsy\n\nNothing Can Stop Me
Heavens to Betsy\n\nTerrorist = Heavens to Betsy\n\nTerrorist
Hey, it's one of the postcards I sent = Эй, это же одна из открыток, что я посылала
Hi Mom, Dad, & Sam,\n\nI have had a wonderful time on the beaches of Barcelona. Dad & Sam, I think you would like the Gaudi architecture. It is from a strange alien world.\n\nI am headed to my final destination, Amsterdam. For how long? That depends! I am running low on money. I will look for a cheap standby ticket and call you when I'm headed home. Sorry for the short notice! Can't wait to see you all again! It'll be good to be home...\n\nLove, Katie = Привет, мам, пап и Сэм,\n\nЯ замечательно провела время на пляжах Барселоны. Папа и Сэм, я думаю, вам бы понравилась архитектура Гауди. Его стиль как будто внеземной.\n\nЯ направилась в конечный пункт назначения - Амстердам. Надолго ли? Понятия не имею! У меня заканчиваются деньги, поэтому я буду искать дешевые билеты домой. Я позвоню вам перед вылетом. Не могу дождаться, чтобы снова увидеть всех вас! Я так соскучилась по дому...\n\nС любовью, Кэти
Hi Mom, Dad, and Sam,\n\nThe Vatican is weird! As you can see, the Catholic Church still has a lot of money left over from the Middle Ages. I've gotten to see all of the art, including the Sistine Chapel ceiling and sculptures by Michaelangelo, Donatello, and the rest of the Ninja Turtles. Mom, we'll have to come back together. I would love to be here with someone who really appreciates the history behind everything. Also, Sam, they have various Relics, as in pieces of important dead people, so you should come too.\n\nNext stop: Barcelona! Calm down, Dad, I won't get gored by a bull. Probably.\n\nLove, Katie = Привет, мам, пап и Сэм,\n\nВатикан странный! Как вы видите, у Католической церкви все еще есть куча денег, оставшихся со Средних веков. Я должна увидеть все здешние творения искусства, включая потолок Сикстинской капеллы и скульптуры Микеланджело, Донателло и других Черепашек-ниндзя. Мама, мы должны съездить сюда c тобой вместе. Мне бы хотелось побывать здесь с кем-то, кто действительно ценит историю. Кроме того, Сэм, у них есть разные Реликвии, например, останки тел важных мертвых людей. Ты тоже должна сюда приехать.\n\nСледующая остановка - Барселона! Успокойся, папа, бык меня не растопчет. Наверно.\n\nС любовью, Кэти
Hi Mom, Dad, and Sam,\nI'm in Paris! I have done many Parisian things, including eating le petit dejeuner and wearing a beret. I'm going to have lots of film to develop when I get back!! Sam, I'm bringing you back something from the Shakespeare Book Company, since you are my favorite sister.\n\nLove you all!\nKatie = Привет, мама, папа, Сэм.\nЯ в Париже! Я уже делала много всякого "парижского", например, отведала "le petit dejeuner", и носила берет. Когда вернусь, у меня будет куча пленки на проявку!! Сэм, тебе я привезу кое-что из книжной лавки "Shakespeare and Company", как своей любимой сестричке.\n\nВсех люблю!\nКэти
Hidden compartments marked on map. Press <Map> to review. = Тайные места отмечены на карте. Нажмите <Map> чтобы посмотреть.
Hide Reticule = Скрыть прицел
High = Высоко
Hold = Зажать
Hold <Zoom> to look closer = Удерживайте <Zoom> чтобы посмотреть поближе
Housekey = Ключ от дома
I sent this one from Barcelona = Я отправляла эту открытку из Барселоны
I think that's mom's citizenship stuff = Думаю, это мамины бумаги о гражданстве
I Want To Believe = Я хочу верить
I... no. = Я... нет.
Insert tape = Вставить кассету
Interact = Действие
Intercept LHO in USSR? ???\nLHO: Killed in Marines? = Перехват Харви Освальда в Советском Союзе? ???\nХарви Освальда убили в морской пехоте?
Invert Look = Инвертировать обзор
Invert Mouse Y = Инверсия оси Y
Items = Вещи
It's Mom's old work mug = Это кружка со старой маминой работы
It's my passport. I got it to go on my Europe trip. = Это мой паспорт. Я получила его для поездки в Европу.
It's Steggy. = Это Стегги.
It's that book Dad wrote = Это та книга, которую написал мой папа
Jan. 12, 1995 = 12 января 1995
JFK President: US + USSR\n\nCoalition? = Президент Джон Ф. Кеннеди: США + СССР\n\nкоалиция?
JFK:\nPoisoned\nkidnapped\nInjured = ДФК:\nОтравленный\nпохищенный\nраненый
Journals = Журналы
Joyce\n\nA Complete Understanding\n\nRichard Greenbriar, Ph.D.\n\nUniversity of Oregon Press = Джойс\n\nПолное осознание\n\nРичард Гринбрайар, доктор наук\n\nИздательство Орегонского университета
Jun. 3, 1995 = 3 июня 1995
Jun. 5, 1995 = 5 июня 1995
Jun. 6, 1995 = 6 июня 1995
June 1995\n\nKatie comes home this month! (Will call with exact date)\n\nJune 3-7: Anniversary Trip = Июнь 1995\n\nКэти приезжает в этом месяце! (Она еще позвонит и скажет когда точно)\n\n3-7 июня: поездка в честь годовщины свадьбы
Junk\nRoom = Чулан
K is for Kind\nA is for Amazing\nI is for Intelligent\nT is for Talented\nL is for Light-Hearted\nI is for Important\nN is for Nice = К - красивая\nЭ - эрудированная\nИ - изумительная\nТ - талантливая\nЛ - ласковая\nИ - игривая\nН - нежная
Kaitlin Greenbriar\nPortland\nFlight 270\nJune 6, 1995 = Кэйтлин Гринбрайар\nПортленд\nРейс 270\n6 июня, 1995
Katie,\nI'm sorry I can't be there to see you, but it is impossible. Please, please don't go digging around trying to find out where I am. I don't want anyone to know.\nWe'll see each other again someday. Don't be worried. I love you.\n-Sam = Кэти,\nМне очень жаль, что я не встречаю тебя, но это сейчас невозможно. Пожалуйста, очень прошу, не пытайся выяснить где я нахожусь. Я не хочу, чтобы об этом кто-то знал.\nКогда-нибудь мы еще увидимся. Не волнуйся. Я люблю тебя.\n-Сэм
KICKING AGAINST THE PATRIARCHY = ВЫСТУПАЯ ПРОТИВ ПАТРИАРХАТА
Kitchen = Кухня
KSNC Presents\n\nSonic Boom '94\n\n\nMay 7, Takelma Fairgrounds = KSNC Представляет\n\nSonic Boom '94\n\n\n7 мая, Экспоцентр Такелма
Language = Язык
Language Options = Выбор языка
Laundry = Прачечная
LB = ЛКМ
Legend of Crystal = "Legend of Crystal"
Library = Библиотека
Locked = Заперто
Locked. = Заперто.
Look closer: <Zoom>      Crouch: <Crouch>\nCheck items: <ShowInventory>      Check map: <Map>      Review journals: <Journal> = Приблизить: <Zoom>      Присесть: <Crouch>\nРюкзак: <ShowInventory>      Карта: <Map>      Журнал: <Journal>
Look closer: <Zoom>      Crouch: <Crouch>\nCheck items: <ToggleInventory>      Check map: <Map>      Review journals: <Journal> = Приблизить: <Zoom>      Присесть: <Crouch>\nРюкзак: <ToggleInventory>      Карта: <Map>      Журнал: <Journal>
Look sensitivity = Чувствительность обзора
Low = Низко
Main Volume = Общая громкость
Making Friends Even When You're Shy\n\nSam- Thought this might help. -Dad = Как заводить друзей, если ты стеснительный\n\nСэм- Решил, что это может помочь тебе. -Папа
Man, Sam had this in like 4th grade = Ого, эта папка была у Сэм в классе, наверно, 4
Manual for Forestry Research and Education\n\nTakelma County Forest Service = Руководство по научно-исследовательской и просветительской работе лесного хозяйства\n\nЛесничество округа Такелма
Map = Карта
Map Disabled\n = Карта отключена\n
Map updated with location of secret door. Press <Map> to review. = Карта обновлена, отмечена тайная дверь. Нажмите <Map> для обзора.
Mar. 11, 1995 = 11 Мар., 1995
Masan's Pharmacy\nJan.-June 1960 = Аптека Масана\nЯнварь - Июнь 1960
Max = Макс.
May 1, 1995 = 1 мая 1995
May 19, 1995 = 19 мая 1995
Medium  = Средне
Millais\n\n\nPacific Institute of Art Exhibition\n\nAugust 19-November 30, 1991 = Милле\n\n\nВыставка в Тихоокеанском институте искусств\n\n19 августа-30 ноября, 1991
Mitten = Миттен
Mitten\n\n1818 Dry Creek Rd. = Миттен\n\n1818, улица Драй Крик
Mitten's Journal - "Meow meow, meow" = Журнал Миттен - "Мяу мяу, мяу"
Modifiers = Модификаторы
Mom & Dad's\nBedroom = Родительская\nспальня
Motion Blur = Размытость
Mouse Acceleration = Ускорение Мыши
Mouse Sensitivity = Чувствительность мыши
Mouse Smoothing = Сглаживание мыши
Move loose board = Взять расшатавшуюся доску
Move the mouse to rotate what you're examining. = Перемещайте мышь, чтобы вращать и осматривать предмет.
Move the thumbsticks to rotate what you're examining. = Перемещайте стики, чтобы вращать и осматривать предмет.
Music Volume = Громкость музыки
Music\nRoom = Музыкальная\nкомната
My passport = Мой паспорт
My trusty Walkman. A constant companion on my travels. = Мой верный "Walkman". Постоянный спутник во время моих путешествий.
My Walkman = Мой "Walkman"
New Game = Новая игра
No = Нет
Nope! = Неа!
Not gonna happen. = Этого не случится.
Nov. 1, 1994 = 1 ноября 1994
Oct. 22, 1994 = 22 октября 1994
Oct. 29, 1994 = 29 октября 1994
Oct. 3, 1994 = 3 октября 1994
Oct. 4, 1994 = 4 октября 1994
Off = Выкл.
Oh man, one of my old sex ed assignments = Вот блин, одно из моих старых заданий по половому воспитанию.
Oh, barf. = Фуу.
Oh, look. A ghost game. = Смотри-ка! Игра про призраков.
Oh, this is one of Granddad's books = О-о, это одна из дедушкиных книг
Oh. It doesn't work. = Хм. Не работает.
Okay, not reading any more of that. = Ладно, не читаю больше такого.
One of dad's books, with something stuck to it? = Одна из папиных книг. Что-то к ней прилеплено?
Open = Открыть
Open armoire = Открыть шкаф
Open attic = Открыть чердак
Open cabinet = Открыть шкафчик
Open cover = Открыть крышку
Open dishwasher = Открыть посудомоечную машину
Open dishwasher rack = Выдвинуть корзину для посуды
Open door = Открыть дверь
Open drawer = Открыть ящик
Open Drawer = Открыть ящик
Open dryer = Открыть сушилку
Open folder = Открыть папку
Open freezer = Открыть холодильник
Open fridge = Открыть холодильник
Open hamper = Открыть корзину
Open lid = Открыть крышку
Open microwave = Открыть микроволновку
Open oven = Открыть печь
Open panel = Открыть панель
Open pizza box = Открыть коробку из под пиццы
Open safe = Открыть сейф
Open sewing table = Открыть швейный стол
Open sliding door = Отодвинуть дверцу
Open trunk = Открыть ящичек
Open warmer drawer = Открыть теплоудерживающий ящик
Open washer = Открыть стиральную машину
Options = Настройки
or = или
Order this month:\n2 cases brandy\n2 cases rum\n1 barrel whisky\nGovernor remains very pleased with enforcement in Boon County. Believe this arrangement shall hold for some time.\n\nW.R.\nMar. '23 = Заказ на этот месяц:\n2 ящика бренди\n2 ящика рома\n1 бочонок виски\nГубернатор очень доволен ходом дел в Округе Бун. Уверен, это соглашение продержится еще какое-то время.\n\nВ.Р.\nМарт '23
OSCAR\nMasan's Pharmacy = ОСКАР\nАптека Масана
Over the Alps = Над Альпами
Overlay Text = Наложение текста
Paradox results in JFK death being DESIRED OUTCOME?? = Парадокс, который приводит к смерти Джона Ф. Кеннеди - ЖЕЛАЕМЙ ИСХОД??
Pick up cassette case = Взять подкассетник
Pick up family photo = Взять семейное фото
Pick up my old Track trophy = Взять мой старый приз по легкой атлетике
Pick up one of my trophies = Взять один из моих призов
Pick up Ouija board = Взять доску для спиритических сеансов
Play messages = Прослушать сообщения
Play record = Воспроизвести запись
Possession and Exorcism\n\n\n\nInteracting with the Supernatural and Releasing Unwanted Spirits = "Одержимость и Экзорцизм"\n\n\n\nВзаимодействие с потусторонним и изгнание нежелательных духов
Press [658be1]X[-]\nto toggle text = Нажмите [658be1]X[-]\nдля переключения текста
Press <Crouch> to crouch. = Нажмите <Crouch> чтобы присесть.
Press <Map> to check your location in the house. = Нажмите <Map> чтобы увидеть свое местоположение в доме.
Press <ShowInventory> to check the contents of your backpack. = Нажмите <ShowInventory> чтобы проверить содержимое рюкзака.
Press <StopJournal> to stop listening. = Нажмите <StopJournal> чтобы остановить прослушивание.
Press <ToggleInventory> to check the contents of your backpack. = Нажмите <ToggleInventory> чтобы проверить содержимое рюкзака.
Press <Zoom> to examine a held object. = Зажмите  <Zoom> чтобы осмотреть выбранный предмет.
Press > to re-listen to journals. = Нажмите > чтобы прослушать снова.
Press button = Нажмите кнопку
Press water dispenser = Нажать на дозатор воды
Primary = Основные
PrimaryFont = RussianPrimaryFont
Pull chain = Потянуть цепь
Pull handle = Потянуть за рычаг
Pull string = Потянуть за веревку
Put back = Положить обратно
Quit to desktop? = Выйти на рабочий стол?
RB = ПКМ
Read "Letters to Katie" = Прочесть "Письма для Кэти"
Read assignment = Прочесть домашнее задание 
Read brochure = Прочесть брошюру
Read card = Прочесть информацию с карточки
Read chapter = Прочесть главу
Read clipping = Прочесть рекламку
Read codes = Прочесть коды
Read crumpled note = Прочесть смятую записку
Read crumpled pages = Прочесть смятые страницы
Read crumpled paper = Прочесть смятый листок
Read document = Прочесть документ
Read invitation = Прочесть приглашение
Read invoice = Прочесть счет на оплату
Read itinerary = Прочесть расписание рейсов
Read letter = Прочесть письмо
Read newspaper clipping = Прочесть газетную вырезку
Read note = Прочесть записку
Read notes = Прочесть заметки
Read obituary = Прочесть некролог
Read page = Прочесть страницу
Read pages = Прочесть листы
Read personal calendar = Прочесть ежедневник
Read shipping label = Прочесть этикетку
Read slip = Прочесть бланк
Read sternly-worded letter = Прочесть официальное письмо
Read story = Прочесть рассказ
Read TV listing = Прочесть программу передач
Rebind Controls = Сменить управление
-Record JFK off HBO\n-Magic Bullet theory?\n-Lone gunman?\n-X-Files: Check w/ Sam = -Записать "Джон Ф. Кеннеди: Выстрелы в Далласе" с HBO\n-Теория о волшебной пуле?\n-Стрелок-одиночка?\n-"Секретные материалы": Уточнить у Сэм
Red Right Hand\n\nSemi-Permanent Hair Dye = Red Right Hand\n\nПолуперманентная краска для волос
Regional Track and Field Finals\nGirls 100-Meter Relay\nFirst Place\nJamie Blume, Carla Jones, Shawna Rossi, Kaitlin Greenbriar = Финал региональных соревнований по легкой атлетике\n100-метровая эстафета среди девушек\nДжейми Блюм, Карла Джонс, Шона Росси, Кэйтлин Гринбрайар
Regional Track and Field Finals\nGirls Long Jump Event\nKaitlin Greenbriar\nFirst Place = Финал региональных соревнований по легкой атлетике\nпрыжки в длину среди девушек\nКэйтлин Гринбрайар\nПервое место
Resolution: = Разрешение:
Restore Defaults = По умолчанию
Resume = Продолжить
Richard Greenbriar, Ph.D\n\nProfessor Laureate of English\nUniversity of Oregon, 1956 = Ричард Гринбрайар, доктор философии\n\nПрофессор-лауреат по Английскому языку\nУниверситет штата Орегон, 1956
Rick\n\8 o'clock\n\Friday = Рик\n\n20:00\n\nПятница
Sam, Katie, Mom (Jan), and Dad (Terry) = Сэм, Кэти, мама (Джен) и папа (Терри)
Sam:\n\nStop leaving every damn light in the house on! You're as bad as your sister! = Сэм:\n\nПрекрати оставлять свет по всему дому! Ты такая же, как и твоя сестра!
Sam-\nStop leaving every damn light in the house on! You're as bad as your sister! = Сэм-\nПрекрати оставлять свет по всему дому! Ты такая же, как и твоя сестра!
Samantha\n\nS is for Special\nA is for Adorable\nM is for Merry\nA is for Affectionate\nN is for Nice\nT is for Thoughtful\nH is for Honest\nA is for Admirable = Саманта\n\nС - симпатичная\nА - аккуратная\nМ - милая\nА - артистичная\nН - нежная\nТ - трепетная\nА - адекватная
Sam's Darkroom\n\nDo not enter if red lights are on!!!!! = Проявочная Сэм\n\nЕсли горят красные огни - не входить!!!!!
Sam's Journal - "A Very Long Phase" = Журнал Сэм - "Очень долгий период"
Sam's Journal - "Adjusting to the Dark" = Журнал Сэм - "Я привыкла к темноте"
Sam's Journal - "At the New House" = Журнал Сэм - "В новом доме"
Sam's Journal - "Best-Laid Plans" = Журнал Сэм - "Лучшие планы"
Sam's Journal - "Big Gold Star" = Журнал Сэм - "Внутреннее свечение"
Sam's Journal - "Daniel" = Журнал Сэм - "Дэниэл"
Sam's Journal - "Dealing With Roots" = Журнал Сэм - "Покраска волос"
Sam's Journal - "Dedication" = Журнал Сэм - "Посвящение"
Sam's Journal - "Default Friends" = Журнал Сэм - “Друзья по-умолчанию"
Sam's Journal - "First Day of School" = Журнал Сэм - "Первый день в школе"
Sam's Journal - "Getting Lonnie" = Журнал Сэм - "Понять Лонни"
Sam's Journal - "Hanging Out With Girls" = Журнал Сэм - "Тусоваться с девчонками"
Sam's Journal - "I Can Sing" = Журнал Сэм - "Я могу спеть"
Sam's Journal - "I Said Yes" = Журнал Сэм - "Я сказала, да"
Sam's Journal - "In The Attic" = Журнал Сэм - "На чердаке"
Sam's Journal - "It's Different Now" = Журнал Сэм - "Теперь все иначе"
Sam's Journal - "Just Gone" = Журнал Сэм - "Она просто исчезнет"
Sam's Journal - "Lie-to-Mom-and-Dad Situation" = Журнал Сэм - "Ситуация соври-маме-и-папе"
Sam's Journal - "Life Moves On" = Журнал Сэм - "Жизнь продолжается"
Sam's Journal - "Ship Date" = Журнал Сэм - "Дата отправления"
Sam's Journal - "Stick With The Group"  = Журнал Сэм - "Держись с группой"
Sam's Journal - "The Nunnery" = Журнал Сэм - "Женский монастырь"
Sam's Journal - "There Was Nothing Wrong" = Журнал Сэм - “В этом не было ничего плохого”
Sam's Journal - "Where I Need To Be" = Журнал Сэм - "Я там, где должна быть"
Sam's Room = Комната\nСэм
Save & Quit to Desktop = Сохранить и выйти на рабочий стол
Save & Quit to Menu = Сохранить и выйти в меню
Save progress and quit to main menu? = Сохранить и выйти в главное меню?
Scrutinize = Осмотреть
Secondary = Дополнительные
SecondaryFont = RussianSecondaryFont
Secret passage marked on map. Press <Map> to review = Секретный проход был отмечен на карте. Нажмите <Map> чтобы посмотреть
Sept. 13, 1994 = 13 сентября, 1994
Sept. 15, 1994 = 15 сентября, 1994
Sept. 6, 1994 = 6 сентября, 1994
Servant's\nQuarters = Покои\nприслуги
Sewing\nRoom = Швейная      \nкомната
Shadow Distance = Дистанция теней
Show All Resolutions = Показать все разрешения
Show Training Messages = Показывать обучающие сообщения
Sitting\nRoom = Комната\n     отдыха
Slide door = Сдвинуть дверь
Sonic Youth\n\nThe Amps\n\nBikini Kill = Sonic Youth\n\nThe Amps\n\nBikini Kill
Sound = Звук
Sound Effects Volume = Громкость эффектов
Sound Options = НАСТРОЙКИ ЗВУКА
Stare = Всмотреться
Start = Старт
Starting a new game will overwrite \nexisting game progress. \nAre you sure? = Начало новой игры перезапишет текущий игровой прогресс. \nВы уверены?
State of Emergency in Dallas cancels motorcade = Парад автомобилей в Далласе был отменен\nиз-за введения чрезвычайного положения
Sticky Targeting = Автоудержание
Stop playback = Остановить воспроизведение
Stop record = Остановить запись
Storage = Складское\n помещение
Strong Pines\nA Couples' Counseling Retreat\n\nBOOKED: June 3-7, 1995 = "Strong Pines"\nКонсультирование супружеских пар\n\nЗАБРОНИРОВАНО: 3-7 Июня, 1995
Super Spitfire = "Super Spitfire"
Swap Left/Right Sticks = Сменить Левый/Правый стики
Switch fan = Включить/выключить вентилятор
Switch to Gamepad = Переключиться на геймпад
Switch to Mouse and Keyboard = Переключиться на клавиатуру и мышь
Take 1st combo scrap = Взять первый листок с комбо ударами
Take 2nd combo scrap = Взять второй листок с комбо ударами
Take attic key = Взять ключ от чердака
Take housekey = Взять ключ от дома
Take key = Взять ключ
Take little allen wrench = Взять маленький гаечный ключ
Take your time. I'm glad to have it in good hands.\n\-Rick = Не торопись. Я рад, что книга в хороших руках.\n\n-Рик
Takelma County Forestry Service\nJanice Greenbriar\nSenior Conservationist = Лесничество Округа Такелма\nДженис Гринбрайар\nСтарший специалист по охране природы
Terrence L. Greenbriar\n\nThe Accidental Pariah = Терренс Л. Гринбрайар\n\n"Случайный изгнанник"
Terrence L. Greenbriar\n\nThe Accidental Savior = Терренс Л. Гринбрайар\n\n"Случайный спаситель"
Terry Age 12\nThanksgiving 1963 = Терри 12 лет\nДень благодарения 1963
Text = Текст
The Accidental Human\n\nby Terrence L. Greenbriar = "Случайный человек"\n\nавтор Терренс Л. Гринбрайар
The Accidental Pariah\nTerrence L. Greenbriar\n\n\nAnother UNKNOWN DIMENSION LITERATURE Discovery = "Случайный изгнанник"\nТерренс Л. Гринбрайар\n\n\nЕще одно открытие издательства "UNKNOWN DIMENSION"
The Accidental Savior\nTerrence L. Greenbriar\n\n\nAnother UNKNOWN DIMENSION LITERATURE Discovery = "Случайный спаситель"\nТерренс Л. Гринбрайар\n\n\nЕще одно открытие издательства "UNKNOWN DIMENSION"
The Accidental Warrior\n\nTerrence L. Greenbriar\n\nDon't give up on this, honey! = "Случайный воитель"\nТерренс Л. Гринбрайар\n\nНе забрасывай это, милый!
The completed combination for the locker in Sam's room. = Полная комбинация от шкафчика в комнате Сэм.
The first half of the combination to Sam's locker. = Первая часть комбинации от шкафчика в комнате Сэм.
The Great Goodfellow Riot of '95 = Знаменитый бунт "Гудфеллоу" в 1995
The Killing of JFK: A Theory\n\nYou've Seen the Movie\nDiscover the Truth = Убийство Кеннеди: Теория\n\nВы смотрели фильм\nУзнайте же правду
The Miss-Fits = The Miss-Fits
The second half of the combo for Sam's locker. = Вторая часть комбинации от шкафчика в комнате Сэм.
The Slits = The Slits
The tag says "attic." = На бирке написано "чердак".
The tag says "Basement." = На бирке написано "подвал".
The Wipers = The Wipers
There you go, Christmas Duck. = Тут тебе самое место, Рождественская Утка.
There's nothing I don't hate right now. = Тут нет ничего, что вызвало бы теперь мою ненависть.
These modifiers result in a non-standard experience.\n      Modifiers cannot be changed while in-game. = Модификаторы изменяют стандартный игровой процесс.\n      Модификаторы нельзя будет изменить в процессе игры.
This can open the heating vent covers on the first floor. = Это поможет открыть вентиль нагревателя, на первом этаже.
This is my boarding pass back from my year in Europe. = Мой посадочный талон из Европы.
to 2nd Floor = на 2-й этаж
to Attic = на Чердак
to Basement = в Подвал
to Downstairs = на Нижний этаж
to Guestroom = в Комнату\nдля гостей
to Upstairs =на Верхний этаж
to\nBasement = в\nПодвал
to\nUpstairs = на\nВерхний этаж
Toggle = Вкл\Выкл
Turn faucet off = Закрыть кран
Turn faucet on = Открыть кран
Turn lamp off = Выключить лампу
Turn lamp on = Включить лампу
Turn off = Выключить
Turn off lights = Выключить свет
Turn on lights = Включить свет
Turn TV off = Выключить телевизор
Turn TV on = Включить телевизор
TV Room = Комната\nс ТВ
Twist sconce = Сдвоенный подсвечник
Ugh. = Хех.
United States Department of Agriculture\n\nUS National Forestry Manual\n\Northwest Region Prescribed Burn Procedures and Precautions = Министерства Сельского хозяйства Соединенных Штатов\n\nРуководство Национальным лесничествам\n\nСеверо-западная область, предписания по контролируемому выжегу и меры предосторожности
Unknown Dimension Literature\n\nKaz\nPublisher = "Unknown Dimension"\n\nКаз\nИздатель
Unlock = Открыть
UNLOCK ALL DOORS - Every door starts unlocked.\nExplore the house, and the story, in any order. = ВСЕ ДВЕРИ ОТКРЫТЫ - Исследуйте дом и \nсюжетную линию в любом порядке.
Unlock door = Открыть дверь
Unlock from the inside = Открывается изнутри
Unlock locker = Открыть шкафчик
Unlocked! = Открыто!
Up a Floor = Этажем выше
Vent tool = Гаечный ключ
View Backpack = Рюкзак
View Journals = Журнал
View Map = Карта
Voice Volume = Громкость голоса
Vsync = Vsync
Walk Backwards = Назад
Walk Forwards = Вперед
Walk Left =  Влево
Walk Right = Вправо
Walt Whitman\n\Leaves of Grass = Уолт Уитмен\n\n"Листья травы"
Watercolor Technique = "Техника акварельной живописи"
What if JFK wasn't JFK?? = Что если Джон Ф. Кеннеди не был  Джоном Ф. Кеннеди??
Why not disrupt motorcade minutes before LHO can fire? = Почему авто кортеж не был разрознен, за минуты до того, как Освальд смог выстрелить?
Wildfire\n\nHe saved her from the raging flames...and then things really heated up! = Лесной пожар\n\nОн спас ее от яростного огня... но полыхающие чувства уже было не остановить!
World History = Всемирная История
X-Ray Spex = X-Ray Spex
Yes = Да
You Can Do Better = Ты способен на большее
Zoom = Приблизить